TREE(3) : Kruskal's tree theorem
The Law of Large Numbers : Law of large numbers
Trigonometric functions : Trigonometric functions
Vector field : Vector field
Taylor Series : Taylor series
0 to the power of 0 equals 1 : Zero to the power of zero
Golden Ratio : Golden ratio
Calculating Pi : Approximations of Pi
Impossible objects : Impossible object
Logarithmic spiral : Logarithmic spiral
Hyperbolic functions : Hyperbolic functions
Tensors : Tensor
Roman surface : Roman surface
Fourier series : Fourier series
The New States Paradox : Coherence (fairness)
Is one infinity greater than another infinity? : None
Millennium Prize Problems : Millennium Prize Problems
Scalar field : Scalar field
Complex analysis : Complex analysis
Four-dimensional space : Four-dimensional space
Prisoner's Dilemma : Prisoner's dilemma
Napoleon points : Napoleon points
Interesting number paradox : Interesting number paradox
Klein bottle : Klein bottle
Julia set : Julia set
Knot theory : Knot theory
Three Prisoners problem : Three Prisoners problem
Silver ratio : Silver ratio
Differentiable manifold : Differentiable manifold
Vecten points : Vecten points
The most beautiful formula : Euler's identity
Four color theorem : Four color theorem
Moving sofa problem : Moving sofa problem
Gamma function : Gamma function
Two envelopes problem : Two envelopes problem
Hilbert space : Hilbert space
Singular value decomposition : Singular value decomposition
Negativedimensional space : None
P=NP? : P versus NP problem
Theory of random matrices : Random matrix
Zero-dimensional space : Zero-dimensional space
Yang-Mills theory : Yang–Mills theory
Klein four-group : Klein four-group
Divergence theorem : Divergence theorem
Sumerians and the number 60 : 60 (number)
Laplace transform : Laplace transform
Attractor : Attractor
Riemannian geometry : Riemannian geometry
Riemann surfaces : Riemann surface
Mobius Strip : Möbius strip
Tensor field : Tensor field
Monty Hall problem : Monty Hall problem
Hilbert's Infinite Hotel Paradox : Hilbert's paradox of the Grand Hotel
Graham's Number : Graham's number
Zeno's paradoxes : Zeno's paradoxes
Banach space : Banach space
Busy beaver : Busy beaver
Potato paradox : Potato paradox
Travelling salesman problem : Travelling salesman problem
Riemann hypothesis : Riemann hypothesis
Stokes' Theorem : Stokes' theorem
Projective variety : Projective variety
Stewart's Theorem : Stewart's theorem
Hall's marriage theorem : Hall's marriage theorem
Chinese postman problem : Mixed Chinese postman problem
Ramsey's Theorem : Ramsey's theorem
Newton fractal : Newton fractal
Cohomology : Cohomology
Clifford algebra : Clifford algebra
Mandelbrot set : Mandelbrot set
Galois theory : Galois theory
Homeomorphism : Homeomorphism
Achilles and the tortoise : Achilles and the tortoise
Infinitesimal transformation : Infinitesimal transformation
St. Petersburg paradox : St. Petersburg paradox
Things named after Leonhard Euler : List of things named after Leonhard Euler
Symplectic geometry : Symplectic geometry
E7 Lie Groups : E7 (mathematics)
The Painter's Paradox : Gabriel's horn
The Heap Paradox : Sorites paradox
Fermat's Great Theorem : Fermat's Last Theorem
P-adic analysis : P-adic analysis
Galileo's paradox : Galileo's paradox
Hyperbolic geometry : Hyperbolic geometry
The universe is a torus? : Shape of the universe
Collatz conjecture : Collatz conjecture
Hedgehog theorem : Hairy ball theorem
Grobner's basis : Gröbner basis
Lobachevsky Space : Hyperbolic space
Hodge conjecture : Hodge conjecture
Bottle Imp paradox : The Bottle Imp
Automorphic form : Automorphic form
Newcomb's paradox : Newcomb's paradox
Seven Bridges of Königsberg : Seven Bridges of Königsberg
Poincaré disk model : Poincaré disk model
Infinitely nested radicals : Nested radical
Sturm–Liouville theory : Sturm–Liouville theory
Proof of Poincare conjecture : Poincaré conjecture
Groupoid : Groupoid 
Arrow's paradox : Arrow's impossibility theorem
Inverting the sphere : Sphere eversion
Homological mirror symmetry : Homological mirror symmetry
Existence and smoothness of solutions of Navier-Stokes equations : Navier–Stokes existence and smoothness
Kőnig's infinity lemma : Kőnig's lemma
Banach–Tarski paradox : Banach–Tarski paradox
The Birch — Swinnerton-Dyer conjecture : Birch and Swinnerton-Dyer conjecture
Rayo's number : Rayo's number
Perfectoid spaces : Perfectoid space
Complex numbers : Complex number
Multidimensional Calabi-Yau space : Calabi–Yau manifold
Quaternions : Quaternion
Mathematical logic : Mathematical logic
Set theory : Set theory
Gödel's incompleteness theorems : Gödel's incompleteness theorems
Number Theory : Number theory
Cardinal : Cardinal number
pi : Pi
e : e (mathematical constant)
Octonion : Octonion
Sedenion : Sedenion
Hyperreal numbers : Hyperreal number
Surreal numbers : Surreal number
Numbers : Number
Integers : Integer
Natural numbers : Natural number
Rational numbers : Rational number
Real numbers : Real number
Period of the number : Repeating decimal
Ordinal numbers : Ordinal number
Supernatural numbers : Supernatural number
Interval numbers : Interval arithmetic
Hurwitz's Theorem : Hurwitz's theorem
Frobenius Theorem : Frobenius theorem (real division algebras)
The Crisis of the foundations of mathematics : Foundations of mathematics
Münchhausen trilemma : Münchhausen trilemma
Category Theory : Category theory
Prime numbers : Prime number
Order theory : Order theory
Group theory : Group theory
Combinatorics : Combinatorics
Graph : Graph
Linear algebra : Linear algebra
Measure theory : Measure (mathematics)
Matrices : Matrix (mathematics)
Vectors : Vector
Topology : Topology
Differential geometry : Differential geometry
Geometry : Geometry
Algebra : Algebra
Fractal geometry : Fractal
Trigonometry : Trigonometry
Chaos Theory : Chaos theory
Dynamic systems : Dynamical systems theory
Gradient : Gradient
Differential : Differential
Integral : Integral
Derivative : Derivative
Differential equations : Differential equation
Vector calculus : Vector calculus
The first equation : The Whetstone of Witte
0 : 0
Probability theory : Probability theory
1 : 1
Ultimate Huge Numbers Iceberg : None
Number systems : Numeral system
Line integral : Line integral
Solomon's knot : Solomon's knot
Whitehead link : Whitehead link
Braid group : Braid group
Tait conjectures : Tait conjectures
Seifert surface : Seifert surface
Wild Knot : Wild knot
Paradoxes of set theory : Paradoxes of set theory
Venn diagram : Venn diagram
Fundamental theorem of arithmetic : Fundamental theorem of arithmetic
Euclidean algorithm: Euclidean algorithm
Perfect numbers : Perfect number
Unusual numbers : Unusual number
Smooth numbers : Smooth number
Rough numbers : Rough number
Regular numbers : Regular number
Weird numbers : Weird number
Abundant numbers : Abundant number
Aliquot sequence : Aliquot sequence
Deficient numbers : Deficient number
Friendly numbers : Friendly number
Amicable numbers : Amicable number
Untouchable numbers : Untouchable number
Geometry of numbers : Geometry of numbers
Lucky numbers : Lucky Numbers
Figurate numbers : Figurate number
Fibonacci numbers : Fibonacci sequence
Wall–Sun–Sun prime : Wall–Sun–Sun prime
Sociable numbers: Sociable number
Factorion : Factorion
Factorial : Factorial
Vampire number : Vampire number
Distribution of prime numbers : Prime number theorem
Ulam spiral : Ulam spiral
196 number problem : Lychrel number
Landau's problems : Landau's problems
Gauss circle problem : Gauss circle problem
Hilbert's problems : Hilbert's problems
Conway's 99-vertex graph problem : Conway's 99-graph problem
Smale's problems : Smale's problems
Burali-Forti paradox : Burali-Forti paradox
Monster group : Monster group
Tarski monster group : Tarski monster group
Matroid : Matroid
Sum-Product Conjecture : Erdős–Szemerédi theorem
Fair division problem : Fair division
Borsuk-Ulam theorem : Borsuk–Ulam theorem
Borsuk's hypothesis : Borsuk's conjecture
Hadwiger–Nelson problem : Hadwiger–Nelson problem
Vitali covering lemma : Vitali covering lemma
PSL(2,7) : PSL(2,7)
Fermat's theorem on sums of two squares : Fermat's theorem on sums of two squarest
Euclid's Elements : Euclid's Elements
Archimedes's cattle problem : Archimedes's cattle problem
The Sand Reckoner : The Sand Reckoner
Determinant : Determinant
Representation theory : Representation theory
Cauchy principal value : Cauchy principal value
Curve length : Arc length
Integral equation : Integral equation
Multiple integral : Multiple integral
Line integral : Line integral
Integration in the mind : None
Vector field flux : Flux (math)
Antiderivative : Antidericative
Fractional derivative : Fractional calculus
Differintegral : differintegral
Fourier transform : Fourier transform
Integral transform : Integral transform
Integral operator : Integral operator
Trigonometric Fourier series : Fourier series
Lebesgue's density theorem : Lebesgue's density theorem
Euclidean space : Euclidean space
Conic sections : Conic section
Cubic plane curve : Cubic plane curve
Quartic plane curve : Quartic plane curve
Parametric equations : Parametric equation
Polar coordinate system : Polar coordinate system
Equations in polar coordinates : Polar coordinate system
Lissajous curve : Lissajous curve
Superformula : Superformula (equation)
Dandelin spheres : Dandelin spheres
Second-order surfaces : Conic section
Affine space : Affine space
The nine-point theorem on a cubic curve : None
Roses : Rose (mathematics)
Menger sponge : Menger sponge
Sierpiński triangle : Sierpiński triangle
Sierpinski carpet : Sierpiński carpet
Apollonian gasket : Apollonian gasket
Fractals : Fractal
Multifractal : Multifractal system
Koch snowflake : Koch snowflake
Cantor set : Cantor set
How Long Is the Coast of Britain? : How Long Is the Coast of Britain? Statistical Self-Similarity and Fractional Dimension
Coastline paradox : Coastline paradox
Tarski's circle-squaring problem : Tarski's circle-squaring problem
Percolation theory : Percolation theory
Lyapunov Fractal : Lyapunov fractal
Dragon curve : Dragon curve
Barnsley fern : Barnsley fern
Fractal dimension : Fractal dimension
CW-complex : CW complex
Homotopy : Homotopy
Betti number : Betti number
Handle decomposition : Handle decomposition
Euclid's axioms and postulates : Euclidean geometry
Variable : Variable
Function : Function
Linear map : Linear map
K-theory : K-theory
Ring : Ring (mathematics)
Field : Field (mathematics)
Invariant theory : Invariant theory
Zariski's main theorems : Zariski's main theorem
Methods of computing square roots : Methods of computing square roots
Fraction : Fraction
Exponentiation : Exponentiation
Root : nth root
Factorization : Factorization
Schur's inequality : Schur's inequality
Series multisection : Series multisection
Arithmetic progression : Arithmetic progression
Geometric progression : Geometric progression
Series : Series (mathematics)
Sum of all natural numbers : 1 + 2 + 3 + 4 + ⋯
Laurent Series : Laurent series
Limit : Limit (mathematics)
Numeric sequence : Sequence
Unit circle : Unit circle
Pythagorean theorem : Pythagorean theorem
Quadratic reciprocity : Quadratic reciprocity
Pythagorean triple : Pythagorean triple
Truth Table : Truth table
Baker's map : Baker's map
Bifurcation theory : Bifurcation theory
Wiener process : Wiener process
Quantum Chaos : Quantum chaos
Axiom A : Axiom A
Edge of chaos : Edge of chaos
Lyapunov's time : Lyapunov time
Correlation integral : Correlation integral
Campbell's Theorem : Campbell's theorem (probability)
Self-organization : Self-organization
Sharkovskii's theorem : Sharkovskii's theorem
Ricker model : Ricker model
Vector spherical harmonics : Vector spherical harmonics
Hypergeometric function : Hypergeometric function
Dirichlet problem : Dirichlet problem
Neumann boundary condition : Neumann boundary condition
Cauchy problem : Cauchy problem
Three-body problem : Three-body problem
Isocline : Isocline
Boundary value problem : Boundary value problem
Shooting method : Shooting method
Stiff equation : Stiff equation
Method of undetermined coefficients : Method of undetermined coefficients
Frobenius method : Frobenius method
Wronskian : Wronskian
Van der Pol oscillator : Van der Pol oscillator
Noether's theorem : Noether's theorem
Poincare map : Poincaré map
Bendixson–Dulac theorem : Bendixson–Dulac theorem
Logistic function : Logistic function
String dispute : Спор_о_струне
Spherical functions : Spherical function
Autonomous system : Autonomous system (mathematics)
Robin boundary condition : Robin boundary condition
Oscillation theory : Oscillation theory
Hurwitz matrix : Hurwitz matrix 
Poincare-Bendixson theorem : Poincaré–Bendixson theorem
Integrability conditions for differential systems : Integrability conditions for differential systems
The Lane-Emden equation : Lane–Emden equation
Liouville's formula : Liouville's formula
Mathieu functions : Mathieu function
Phase space : Phase space
Fundamental matrix : Fundamental matrix
Toda lattice : Toda lattice
Normal : Normal (geometry)
Norm : Norm (mathematics)
Airy function : Airy function
Collinearity : Collinearity
Coplanarity : Coplanarity
Unit vector : Unit vector
Cross product : Cross product
Dot product : Dot product
Laplacian : Laplace operator
Stochastic differential equation : Stochastic differential equation
Helmholtz decomposition : Helmholtz decomposition
Solenoidal vector field : Solenoidal vector field
Field line : Field line
Triple product : Triple product
Minkowski space : Minkowski space
Law of the iterated logarithm : Law of the iterated logarithm
Kolmogorov's zero–one law : Kolmogorov's zero–one law
Law of small numbers : Law of small numbers
Benford's Law : Benford's law
Newton–Pepys problem : Newton–Pepys problem
Gambler's ruin : Gambler's ruin
Galton board : Galton board
Giant component : Giant component
Lebesgue integral : Lebesgue integral
Copula : Copula (probability theory)
Impossible event : None
Inverse transform sampling : Inverse transform sampling
Expected value : Expected value
De Moivre–Laplace theorem : De Moivre–Laplace theorem
Gaussian process : Gaussian process
Bayesian probability : Bayesian probability
Probability density : Probability density function
Bayes ' theorem : Bayes' theorem
Central limit theorem : Central limit theorem
Bradford's law : Bradford's law
Raikov's Theorem : Raikov's theorem
Doomsday argument : Doomsday argument
Infinite monkey theorem : Infinite monkey theorem
Degrees of freedom : Degrees of freedom (statistics)
Standard deviation : Standard deviation
Singular distribution : Singular distribution
Hill differential equation : Hill differential equation
Negative frequency : Negative frequency
Planimetrics : Planimetrics
Solid geometry : Solid geometry
Peano фxioms : Peano axioms
Berlekamp–Rabin algorithm : Berlekamp–Rabin algorithm
Asymptotic density : Natural density
Presburger arithmeticc : Presburger arithmetic
Schoof's algorithm : Schoof's algorithm
Tonelli-Shanks algorithm : Tonelli–Shanks algorithm
Baby-step giant-step : Baby-step giant-step
Probable prime : Probable prime
Coprime integers : Coprime integers
Harmonic number : Harmonic number
Hemiperfect number : Hemiperfect number
Artin's conjecture : Artin's conjecture on primitive roots
Beal conjecture : Beal conjecture
Restricted partial quotients : Restricted partial quotients
Bateman-Horn conjecture : Bateman–Horn conjecture
Lander, Parkin, and Selfridge conjecture : Lander, Parkin, and Selfridge conjecture
Mahler's 3/2 problem : Mahler's 3/2 problem
Faltings's theorem : Faltings's theorem
Lonely runner conjecture : Lonely runner conjecture
Covering system : Covering system
Singmaster's conjecture : Singmaster's conjecture
Paley graph : Paley graph
Addition : Addition
Subtraction : Subtraction
Multiplication : Multiplication
Division : Division
Logarithm : Logarithm
Fermat–Catalan conjecture : Fermat–Catalan conjecture
Znám's problem : Znám's problem
Brocard's problem : Brocard's problem
Diophantine quintuple : Diophantine quintuple
Digamma function : Digamma function
Dedekind Zeta function : Dedekind zeta function
Erdos conjecture on arithmetic progressions : Erdős conjecture on arithmetic progressions
Euler's conjecture : Euler's conjecture
Binomial theorem : Binomial theorem
Darboux integral : Darboux integral
Feit-Thompson conjecture : Feit–Thompson conjecture
Perfect numbers : Perfect number
Perfect digital invariant : Perfect digital invariant
Dirichlet integral : Dirichlet integral
Colossally abundant numbers : Colossally abundant number
Congruent number : Congruent number
Landau–Ramanujan constant : Landau–Ramanujan constant
Euler's criterion : Euler's criterion
Mills' Constant : Mills' constant
Ford Circles : Ford circle
Euclid's lemma : Euclid's lemma
Zolotarev's Lemma : Zolotarev's lemma
Golomb ruler : Golomb ruler
Magic square : Magic square
Magic cube : Magic cube
Magic hexagon : Magic hexagon
Fermat's little theorem : Fermat's little theorem
Liouville number : Liouville number
Dirichlet hyperbola method : Dirichlet hyperbola method
Module : Module (mathematics)
GCD : Greatest common divisor
Least common multiple : Least common multiple
Normal numbers : Normal number
Semiprime : Semiprime
Semiperfect number : Semiperfect number
Generalized taxicab number : Generalized taxicab number
Euler's constant : Euler's constant
Champernowne constant : Champernowne constant
Glaisher–Kinkelin constant : Glaisher–Kinkelin constant
Apery constant : Apéry's constant
Plastic number : Plastic number
Sylvester sequence : Sylvester's sequence
Juggler sequence : Juggler sequence
Polygamma function : Polygamma function
Pisano Period : Pisano period
Wieferich pair : Wieferich pair
Gelfond's constant : Gelfond's constant
Feigenbaum Constants : Feigenbaum constants
Supergolden ratio : Supergolden ratio
Golden triangle : Golden triangle (mathematics)
Golden rhombus : Golden rhombus
Kepler triangle : Kepler triangle
Gnomon : Gnomon
Golden spiral : Golden spiral
Golden angle : Golden angle
Rule of thirds : Rule of thirds
Pseudoprime : Pseudoprime
Primorial : Primorial
Vieta jumping : Vieta jumping
Difference of two squares : Difference of two squares
Vieta's formulas : Vieta's formulas
Pythagorean prime : Pythagorean prime
Newman–Shanks–Williams prime: Newman–Shanks–Williams prime
Primitive abundant number : Primitive abundant number
Arithmetic derivative : Arithmetic derivative
Primorial prime : Primorial prime
Lucas number : Lucas number
Fermat primality test : Fermat primality test
Frobenius pseudoprime : Frobenius pseudoprime
Chinese remainder theorem : Chinese remainder theorem
Möbius function : Möbius function
Basel problem : Basel problem
Farey sequence : Farey sequence
Kronecker symbol : Kronecker symbol
Kronecker symbol : Kronecker delta
Sum-free set : Sum-free set
Square-free integer : Square-free integer
Dirichlet convolution : Dirichlet convolution
Quasiperfect number : Quasiperfect number
Superabundant number : Superabundant number
Ramanujan's sum : Ramanujan's sum
Kloosterman sum : Kloosterman sum
Perfect power : Perfect power
Unitary matrix : Unitary matrix
Harmonic divisor number : Harmonic divisor number
Composite number : Composite number
Van der Waerden's theorem : Van der Waerden's theorem
Erdős–Kac theorem : Erdős–Kac theorem
Schur's Theorem : Schur's theorem
Chen's theorem : Chen's theorem
Fermat polygonal number theorem : Fermat polygonal number theorem
Szemerédi's theorem : Szemerédi's theorem
Lucas's theorem : Lucas's theorem
Linnik's theorem : Linnik's theorem
Lindemann–Weierstrass theorem : Lindemann–Weierstrass theorem
Legendre's three-square theorem : Legendre's three-square theorem
Wilson's Theorem : Wilson's theorem
Euler's Theorems : List of things named after Leonhard Euler
Beta function : Beta function
Trigamma function : Trigamma function
Ramanujan's ternary quadratic form : Ramanujan's ternary quadratic form
Euler's four-square identity : Euler's four-square identity
Degen's eight-square identity : Degen's eight-square identity
APR Test : Adleman–Pomerance–Rumely primality test
Unique primes : Reciprocals of primes
Thue equation : Thue equation
Cyclic number : Cyclic number
Factorial prime : Factorial prime
Higgs primes : Higgs prime
Liouville function : Liouville function
Divisor function : Divisor function
Abel's summation formula : Abel's summation formula
Graph of a function : Graph of a function
Dirichlet function : Dirichlet function
Floor and ceiling functions : Floor and ceiling functions
Parity : Parity (mathematics)
Fermat quotient : Fermat quotient
Zeisel number : Zeisel number
Fermat Number : Fermat number
Taxicab number : Taxicab number
Perrin Number : Perrin number
Pell Number : Pell number
Cunningham number : Cunningham number
Van der Waerden number : Van der Waerden number)
Twin prime : Twin prime
Artin–Hasse exponential : Artin–Hasse exponential
P-adic number : P-adic number
abc conjecture : abc conjecture
Transpose : Transpose
Triangle center : Triangle center
Circle : Circle
Angle : Angle
Happy ending problem : Happy ending problem
Crossed ladders problem :Crossed ladders problem
Napoleon's problem : Napoleon's problem
Gabriel graph : Gabriel graphe
Lune of Hippocrates : Lune of Hippocratest
Tarry point : Tarry point
Wittgenstein's rod : Wittgenstein's rod
Beta skeleton :Beta skeleton
Disk : Disk (mathematics)
Isogonal conjugate : Isogonal conjugate
Euclidean tilings by convex regular polygons : Euclidean tilings by convex regular polygons
Radian : Radian
Miquel's theorem : Miquel's theorem
Trillium theorem : Trillium theorem
Leibniz's Theorem : Leibniz theorem
Nine-point conic : Nine-point conic
Kosnita's Theorem : Kosnita's theorem
Isotomic conjugate : Isotomic conjugate
Ptolemy's Inequality : Ptolemy's inequality
Bretschneider ratio : Bretschneider's formula
Similarity : Similarity (geometry)
Steiner chain : Steiner chain
Brahmagupta theorem : Brahmagupta theorem
Pasch's theorem : Pasch's theorem
Sum of angles in a polygon : None
Law of sines : Law of sines
Intersecting chords theorem : Intersecting chords theorem
Butterfly theorem : Butterfly theorem
Monge's Theorem : Monge's theorem
Descartes' theorem : Descartes' theorem
Varignon's theorem : Varignon's theorem
Chord : Chord
Pohlke's theorem : Pohlke's theorem
Japanese theorem for cyclic quadrilaterals : Japanese theorem for cyclic quadrilaterals
Brahmagupta's formula : Brahmagupta's formula
Steiner–Lehmus theorem : Steiner–Lehmus theorem
Thales' theorem : Intercept theorem
Thébault's theorem : Thébault's theorem
Sylvester's theorem : Sylvester's theorem
Szemerédi–Trotter theorem : Szemerédi–Trotter theorem
Menelaus's theorem : Menelaus's theorem
Routh's theorem : Routh's theorem
Pompeiu's theorem : Pompeiu's theorem
Lateral surface : Lateral surface
Power of a point : Power of a point
Quadratic form : Quadratic form
Villarceau circles : Villarceau circles
Order of operations : Order of operations
Hypercone : Hypercone
The three-perpendicular theorem : None
Torus : Torus
Dimension : Dimension
Reuleaux tetrahedron : Reuleaux tetrahedron
Pappus's centroid theorem : Pappus's centroid theorem
De Gua's theorem : De Gua's theorem
Euler's Rotation Theorem : Euler's rotation theorem
Steinmetz solid : Steinmetz solid
Surface of constant width : Surface of constant width
Lindenbaum–Tarski algebra : Lindenbaum–Tarski algebra
All horses are the same color : All horses are the same color
Dedekind numbers : Dedekind number
Decidability of first-order theories of the real numbers : Decidability of first-order theories of the real numbers
Lambek Calculus : Categorial grammar
De Morgan's laws : De Morgan's laws
Peirce's law : Peirce's law
Contraposition : Contraposition
Consequentia mirabilis : Consequentia mirabilis
Law of excluded middle : Law of excluded middle
Proof by contradiction : Proof by contradiction
Double negation : Double negation
Quantifier : Quantifier (logic)
Logical connective : Logical connective
Closure operator : Closure operator
Kripke structure : Kripke structure (model checking)
Petrick's method : Petrick's method
Quine–McCluskey algorithm : Quine–McCluskey algorithm
Proof by infinite descent : Proof by infinite descent
Nonstandard analysis : Nonstandard analysis
Curry-Howard correspondence : Curry–Howard correspondence
Iverson bracket : Iverson bracket
Hilbert's program : Hilbert's program
Markov's principle : Markov's principle
Zhegalkin's polynomial : Zhegalkin polynomial
Godel numbering : Gödel numbering
Compactness theorem : Compactness theorem
Entscheidungsproblem : Entscheidungsproblem
Tarski's undefinability theorem : Tarski's undefinability theorem
Liar paradox : Liar paradox
Degeneracy : Degeneracy (mathematics)
Rice's theorem : Rice's theorem
Post's theorem : Post's theorem
Löwenheim–Skolem theorem : Löwenheim–Skolem theorem
Löb's theorem : Löb's theorem
Godel's completeness theorem : Gödel's completeness theorem
Rvachev function : Rvachev function
T-norm : T-norm
Spectral theory : Spectral theory
Spectral theorem : Spectral theorem
Lax pair : Lax pair
Hearing the shape of a drum : Hearing the shape of a drum
Ramanujan graph : Ramanujan graph
Van der Waerden's conjecture : Permanent (mathematics)
Heisenberg Group : Heisenberg group
Diagonalizable matrix : Diagonalizable matrix
Eigenvalues and eigenvectors : Eigenvalues and eigenvectors
Matrix multiplication : Matrix multiplication
Cuthill–McKee algorithm : Cuthill–McKee algorithm
Sylvester's formula : Sylvester's formula
Gaussian elimination : Gaussian elimination
Schur decomposition : Schur decomposition
Wigner's D-matrix : Wigner D-matrix
Levinson's theorem : Levinson's theorem
Cayley–Hamilton theorem : Cayley–Hamilton theorem
Amitsur-Levitsky theorem : Amitsur–Levitzki theorem
Wythoff array : Wythoff array
Levi-Civita symbol : Levi-Civita symbol
Four-tensor : Four-tensor
Convolution of the tensor : Tensor contraction
Kulkarni–Nomizu product : Kulkarni–Nomizu product
Hodge star operator : Hodge star operator
Curry's paradox : Curry's paradox
Curvature tensor : Riemann curvature tensor
Cotton tensor : Cotton tensor
Ratio : Ratio
Tensor product : Tensor product
Multilinear algebra : Multilinear algebra
Complexification : Complexification
Barrel space : Barrelled space
Nash-Moser theorem : Nash–Moser theorem
Reflexive space : Reflexive space
Abelian group : Abelian group
Bäcklund transform : Bäcklund transform
Iterated logarithm : Iterated logarithm
Group : Group (mathematics)
Isomorphism : Isomorphism
Lovász conjecture : Lovász conjecture
Burnside problem : Burnside problem
Discrete logarithm : Discrete logarithm
Higman-Sims graph : Higman–Sims graph
Monstrous moonshine : Monstrous moonshine
Cauchy's theorems : Cauchy theorem
Conjugacy class : Conjugacy class
Cartan — Dieudonne theorem : Cartan–Dieudonné theorem
Jordan–Schur theorem : Jordan–Schur theorem
Line : Line (geometry)
Gromov's theorem on groups of polynomial growth : Gromov's theorem on groups of polynomial growth
Burnside's theorem : Burnside's theorem
Generalized polygon : Generalized polygon
Landau function : Landau's function
SL2(R) : SL2(R)
Erlangen program : Erlangen program
Googol : Googol
Googolplex : Googolplex
Greedy embedding : Greedy embedding
-0 : Signed zero
Arnold's cat map : Arnold's cat map
Snub cube : Snub cube
Evil number : Evil number
The Complexity of Songs : The Complexity of Songs
65537-gon : 65537-gon
Squeeze theorem : Squeeze theorem
Smoot : Smoot
Paper folding limit : None
Schläfli symbol : Schläfli symbol
Tupper's self-referential formula : Tupper's self-referential formula
Schizophrenic number : Schizophrenic number
Erdos number : Erdős number
Monomial : Monomial
Polynomial : Polynomial
Ideal : Ideal (ring theory)
Icosians : Icosian
Casus irreducibilis : Casus irreducibilis
Esquisse d'un Programme : Esquisse d'un Programme
Magma : Magma (algebra)
Direct limit : Direct limit
Loop : Quasigroup
Wheat and chessboard problem : Wheat and chessboard problem
Quadratic equation : Quadratic equation
Pythagorean trigonometric identity : Pythagorean trigonometric identity
Jacobi identity : Jacobi identity
Parallelogram law : Parallelogram law
Santaló's formula : Santaló's formula
L'Hôpital's rule : L'Hôpital's rule
Jacobian : Jacobian matrix and determinant
Amoeba : Amoeba (mathematics)
Galois geometry : Galois geometry
André–Oort conjecture : André–Oort conjecture
Hasse–Weil zeta function : Hasse–Weil zeta function
Divisor : Divisor (algebraic geometry)
Mediant : Mediant (mathematics)
Tate-Shafarevich group : Tate–Shafarevich group
Erdős–Diophantine graph : Erdős–Diophantine graph
Grassmannian : Grassmannian
Falling and rising factorials : Falling and rising factorials
Mirror symmetry : Mirror symmetry (string theory)
Ricci curvature tensor : Ricci curvature
Zariski tangent space : Zariski tangent space
Noether normalization lemma : Noether normalization lemma
Nakayama's Lemma : Nakayama's lemma
Gordan's lemma : Gordan's lemma
Fermat curve : Fermat curve
Proj : Proj construction
Coherent sheaf : Coherent sheaf
Sheaf : Sheaf (mathematics)
Implicit function : Implicit function
Singularity : Singularity (mathematics)
Shimura variety : Shimura variety
Noetherian space : Noetherian topological space
Łojasiewicz inequality : Łojasiewicz inequality
Chebyshev polynomials : Chebyshev polynomial
Cramer's paradox : Cramer's paradox
Hodge structure : Hodge structure
The Hilbert polynomial : Hilbert series and Hilbert polynomial
Blowing up : Blowing up
Jacobian conjecture : Jacobian conjecture
Plucker coordinates : Plücker coordinates
Hodge theory : Hodge theory
Bezout's theorem : Bézout's theorem
Tropical geometry : Tropical geometry
Euler sequence : Euler sequence
Zariski topology : Zariski topology
Deformation : Deformation (mathematics)
AF+BG theorem : AF+BG theorem
Lüroth's theorem : Lüroth's theorem
Kodaira embedding theorem : Kodaira embedding theorem
Quillen-Suslin theorem : Quillen–Suslin theoremn
Birkhoff–Grothendieck theorem : Birkhoff–Grothendieck theorem
Hilbert's Nullstellensatz : Nullstellensatz
Tetration : Tetration
Infinitesimal : Infinitesimal
Regiomontanus' angle maximization problem : Regiomontanus' angle maximization problem
Del : Del
Smooth function : Smoothness
Dihedral angle : Dihedral angle
Hypoelliptic operator : Hypoelliptic operator
Hessian matrix : Hessian matrix
Fermat's theorem : Fermat's theorem (stationary points)
Gateaux derivative : Gateaux derivative
Lie derivative : Lie derivative
Exterior angle : Exterior angle theorem
Curl : Curl (mathematics)
Law of cosines : Law of cosines
Mean value Theorem : Mean value theorem
Right angle : Right angle
Radon–Nikodym theorem : Radon–Nikodym theorem
Partial derivative : Partial derivative
Elliptic operator : Elliptic operator
Q-derivative : Q-derivative
Inflection point : Inflection point
Extremum : Maximum and minimum
Roll's theorem : Rolle's theorem
Functional analysis : Functional analysis
Basis : Basis (linear algebra)
Infinite-dimensional space : Dimension (vector space)
Axiom of choice : Axiom of choice
Multi-scale analysis : Multiple-scale analysis
Vector lattice : Riesz space
Subspace : Linear subspace
Fréchet manifold : Fréchet manifold
Fredholm alternative : Fredholm alternative
Orthogonality : Orthogonality
Parallel : Parallel (geometry)
Fatou's lemma : Fatou's lemma
Hilbert-Schmidt operator : Hilbert–Schmidt operator
Wiener's Tauberian theorem : Wiener's Tauberian theorem
Friedrichs's inequality : Friedrichs's inequality
Minkowski inequality : Minkowski inequality
Cauchy–Schwarz inequality : Cauchy–Schwarz inequality
Hölder's inequality : Hölder's inequality
Bessel's inequality : Bessel's inequality
Bernstein's inequality : Bernstein's theorem (polynomials)
Radon Measure : Radon measure
Scaling function : Scaling function
Seminorm : Seminorm
Uniform continuity : Uniform continuity
Continuity : continious function
Weak derivative : Weak derivative
Weak convergence : Weak convergence
Convergence : Convergent series
Uniform boundedness principle : Uniform boundedness principle
Mollifier : Mollifier
Convolution : Convolution
Weinberg angle : Weinberg angle
Neumann series : Neumann series
Minkowski distance : Minkowski distance
Parseval's identity : Parseval's identity
Banach–Alaoglu theorem : Banach–Alaoglu theorem
Digon : Digon
Open mapping theorem : Open mapping theorem (functional analysis)
Closed graph theorem : Closed graph theorem
Markov-Kakutani fixed-point theorem : Markov–Kakutani fixed-point theorem
Lusin's theorem : Lusin's theorem
Dominated convergence theorem : Dominated convergence theorem
Lions's theorem : Lions–Lax–Milgram theorem
Krein–Milman theorem : Krein–Milman theorem
Egorov's theorem : Egorov's theorem
Hilbert-Schmidt theorem : Hilbert–Schmidt theorem
Bounded inverse theorem : Bounded inverse theorem
Banach fixed-point theorem : Banach fixed-point theorem
Banach–Mazur theorem : Banach–Mazur theorem
Arzelà–Ascoli theorem : Arzelà–Ascoli theorem
Riesz representation theorem : Riesz representation theorem
Riesz–Thorin theorem : Riesz–Thorin theorem
Growth point : Growth point
Monogon : Monogon
Schauder fixed-point theorem : Schauder fixed-point theorem
Hahn-Banach theorem : Hahn–Banach theorem
Dodecagon : Dodecagon
Fubini's theorem : Fubini's theorem
Product of measures : Product measure
Random variable : Random variable
Triangle : Triangle
Cauchy sequence : Cauchy sequence
Kernel : Kernel (linear algebra)
Inner product space : Inner product space
Quadrilateral : Quadrilateral
C*-algebra : C*-algebra
Delone set : Delone set
Rademacher system : Rademacher system
Quotient space : Quotient space (topology)
Pentagon : Pentagon
Ergodicity : Ergodicity
Global analysis : Global analysis
Smooth infinitesimal analysis : Smooth infinitesimal analysis
Catastrophe theory : Catastrophe theory
Limiting parallel : Limiting parallel
Retraction : Retraction (topology)
Hedgehog space : Hedgehog space
Hexagon : Hexagon
Hilbert cube : Hilbert cube
First and second countable space : First-countable space
Embedding : Embedding
Knaster–Kuratowski fan : Knaster–Kuratowski fan
Separation axiom : Separation axiom
Kuratowski's closure-complement problem : Kuratowski's closure-complement problem
Neighbourhood : Neighbourhood (mathematics)
Antoine's necklace : Antoine's necklace
Continuum : Continuum (topology)
Net : Net (mathematics)
257-gon : 257-gon
Chiliagon : Chiliagon
Compactification : Compactification (mathematics)
Myriagon : Myriagon
Megagon : Megagon
Compact space : Compact space
Cartesian product of sets : Cartesian product
Universal space : Universal space
Paracompact space : Paracompact space
k-space : Compactly generated space
G-delta set : Gδ set
Extremally disconnected space : Extremally disconnected space
Lindelöf space : Lindelöf space
Hausdorff space : Hausdorff space
Urysohn's lemma : Urysohn's lemma
Filter : Filter (mathematics)
Lower limit topology : Lower limit topology
Tychonoff cube : Tychonoff cube
Stone's representation theorem for Boolean algebras : Stone's representation theorem for Boolean algebras
Intermediate value theorem : Intermediate value theorem
Continuum hypothesis : Continuum hypothesis
infinite polygon : Apeirogon
Ideal triangle : Ideal triangle
Antiparallelogram : Antiparallelogram
Parallelogram : Parallelogram
Polish space : Polish space
Rectangle : Rectangle
Dense set : Dense set
Tychonoff plank : Tychonoff plank
Moore plane : Moore plane
Bell polynomials : Bell polynomials
Ménage problem : Ménage problem
Stable roommates problem : Stable roommates problem
Weapon target assignment problem : Weapon target assignment problem
Josephus problem : Josephus problem
No-three-in-line problem : No-three-in-line problem
Young's diagram : Young tableau
Twelvefold way : Twelvefold way
Erdős–Graham problem : Erdős–Graham problem
Cameron–Erdős conjecture : Cameron–Erdős conjecture
Aanderaa–Karp–Rosenberg conjecture : Aanderaa–Karp–Rosenberg conjecture
Weighting matrix : Weighing matrix
Abel's binomial theorem : Abel's binomial theorem
Aztec Diamond : Aztec diamond
Robinson–Schensted correspondence : Robinson–Schensted correspondence
Faà di Bruno's formula : Faà di Bruno's formula
Latin Square : Latin square
Sicherman dice : Sicherman dice
Lovász local lemma : Lovász local lemma
Szemerédi regularity lemma : Szemerédi regularity lemma
Burnside's lemma : Burnside's lemma
Combinatorial explosion : Combinatorial explosion
Rhombus : Rhombus
Involution : Involution (mathematics)
Permutation : Permutation
Partial permutation : Partial permutation
Subset : Subset
Combination : Combination
Costas array : Costas array
The multinomial theorem : Multinomial theorem
Square : Square
Stars and bars : Stars and bars (combinatorics)
Meander : Meander (mathematics)
Optimal solutions for Rubik's Cube : Optimal solutions for Rubik's Cube
Pigeonhole principle : Pigeonhole principle
De Bruijn sequence : De Bruijn sequence
Curse of dimensionality : Curse of dimensionality
Pascal's Rule : Pascal's rule
Golomb–Dickman constant : Golomb–Dickman constant
Sidon sequence : Sidon sequence
Thue–Morse sequence : Thue–Morse sequence
Sparse matrix : Sparse matrix
Set packing : Set packing
Pascal's triangle : Pascal's triangle
Transylvanian Lottery : Transylvania lottery
Transversal : Transversal (combinatorics)
Pólya enumeration theorem : Pólya enumeration theorem
Corners theorem : Corners theorem
Road coloring theorem : Road coloring theorem
Matching : Matching (graph theory)
Cayley's formula : Cayley's formula
The Cauchy-Davenport Theorem : Restricted sumset
Koenig's theorem : Kőnig's theorem (graph theory)
Bertrand's election theorem : Bertrand's ballot theorem
Umbral calculus : Umbral calculus
Fisher–Yates shuffle : Fisher–Yates shuffle
T-theory : T-theory
Steiner system : Steiner system
Kirkman's schoolgirl problems : Kirkman's schoolgirl problem
Eulerian number : Eulerian number
Baker-Campbell-Hausdorff formula : Baker–Campbell–Hausdorff formula
Shannon's Number : Shannon number
Bell's Number : Bell number
Stirling numbers : Stirling numbers of the first kind
Catalan numbers : Catalan number
Inclusion-exclusion formula : Inclusion–exclusion principle
Bernoulli formula : Bernoulli number
Graph coloring : Graph coloring
Erdős–Hajnal conjecture : Erdős–Hajnal conjecture
Burr–Erdős conjecture : Burr–Erdős conjecture
Hadwiger's conjectures : Hadwiger conjecture (graph theory)
Sidorenko's conjecture : Sidorenko's conjecture
Second neighborhood problem : Second neighborhood problem
Sumner's conjecture : Sumner's conjecture
Vizing's conjecture : Vizing's conjecture
Hypergraph : Hypergraph
Hamiltonian path : Hamiltonian path
Vertex separator : Vertex separator
Domatic number : Domatic number
Zigzag-artwork : Zig-zag product
Metcalfe's Law : Metcalfe's law
Steiner tree problem : Steiner tree problem
Oberwolfach problem : Oberwolfach problem
Independent set : Independent set (graph theory)
Assignment problem : Assignment problem
Clique problem : Clique problem
Vertex cover : Vertex cover
Shannon capacity : Shannon capacity of a graph
Bramble : Bramble (graph theory)
Dominator : Dominator (graph theory)
15 puzzle : 15 puzzle
Cubic graph : Cubic graph
Rooted graph : Rooted graph
Desargues configuration : Desargues configuration
Cage : Cage (graph theory)
Clique : Clique (graph theory)
Conference graph : Conference graph
Cheeger's constant : Cheeger constant (graph theory)
Connected component : Connected space
Wheel : Wheel theory
Trapezoid : Trapezoid
Prüfer sequence : Prüfer sequence
Cograph : Cograph
Quantum graph : Quantum graph
Interval graph : Interval graph
Crown graph : Crown graph
Spanning tree : Spanning tree
Graph operations : Graph operations
Covering graph : Covering graph
Shannon multigraph : Shannon multigraph
Mycielskian : Mycielskian
Multigraph : Multigraph
Bridge : Bridge (graph theory)
Adjacency matrix : Adjacency matrix
Incident matrix : Incidence matrix
Friendship paradox : Friendship paradox
Star polygon : Star polygon
Regular graph : Regular graph
Hanan Grid : Hanan grid
Node influence metric : Node influence metric
Planar graph : Planar graph
Haus vom Nikolaus : None
Chromatic polynomial : Chromatic polynomial
Regular polygon : Regular polygon
Graph factorization : Graph factorization
Trapezoidal graph : Trapezoid graph
Transitive reduction : Transitive reduction
Optimization : Mathematical optimization
Выпуклый многоугольник : Convex polygon : Convex polygon
Псевдотреугольник : Pseudotriangle : Pseudotriangle
Дельтоид : Kite : Kite (geometry)
Гармонический четырёхугольник : Harmonic quadrilateral : Harmonic quadrilateral
Внеописанный четырёхугольник : Ex-tangential quadrilateral : Ex-tangential quadrilateral
Тридцатиугольник : Triacontagon : Triacontagon
Луч : Ray : Line (geometry)
Отрезок : Line segment : Line segment
Геометрическое место точек : Locus : Locus (mathematics)
Ломаная : Polygonal chain : Polygonal chain
Правильный тетраэдр : Tetrahedron : Tetrahedron
Октаэдр : Octahedron : Octahedron
Правильный икосаэдр : Regular icosahedron : Regular icosahedron
Правильный додекаэдр : Regular dodecahedron : Regular dodecahedron
Пятиячейник : 5-cell : 5-cell
Шестнадцатиячейник : 16-cell : 16-cell
Двадцатичетырёхъячейник : 24-cell : 24-cell
Стодвадцатиячейник : 120-cell : 120-cell
Шестисотячейник : 600-cell : 600-cell
Симплекс : Simplex : Simplex
Гипероктаэдр : Cross-polytope : Cross-polytope
Гиперкуб : Hypercube : Hypercube
Курносый двадцатичетырёхъячейник : Snub 24-cell : Snub 24-cell
Линк вершины многогранника : Vertex figure : Vertex figure
Ортогональная проекция : Orthographic projection : Orthographic projection
Число Коксетера : Coxeter element : Coxeter element
Пятидесятисемиячейник : 57-cell : 57-cell
Однородный четырёхмерный многогранник : Uniform 4-polytope : Uniform 4-polytope
Шестиугольные черепичные соты : Hexagonal tiling honeycomb : Hexagonal tiling honeycomb
Многоугольник Петри : Petrie polygon : Petrie polygon
Комплексный многогранник : Complex polytope : Complex polytope
Гиперсфера : n-sphere : n-sphere
Мера Хаусдорфа : Hausdorff measure : Hausdorff measure
Многочлены Гегенбауэра : Gegenbauer polynomials : Gegenbauer polynomials
Трёхмерная сфера : 3-sphere : 3-sphere
Стереографическая проекция : Stereographic projection : Stereographic projection
Многогранник Гессе : Hessian polyhedron : Hessian polyhedron
Дуопризма : Duoprism : Duoprism
Призма : Prism : Prism (geometry)
Конфигурация Мёбиуса — Кантора : Möbius–Kantor configuration : Möbius–Kantor configuration
Скутоид : Scutoid : Scutoid
Призматоид : Prismatoid : Prismatoid
Бифрустум : Bifrustum : Bifrustum
Фрустум : Frustum : Frustum
Архимедово тело : Archimedean solid : Archimedean solid
Тороидальный многогранник : Toroidal polyhedron : Toroidal polyhedron
Архимедов граф : Archimedean graph : Archimedean graph
Квазиправильный многогранник : Quasiregular polyhedron : Quasiregular polyhedron
Усечение : Truncation : Truncation (geometry)
Антипризма : Antiprism : Antiprism
Пирамида : Pyramid : Pyramid (geometry)
Каталановы тела : Catalan solid : Catalan solid
Диаграмма Шлегеля : Schlegel diagram : Schlegel diagram
Диэдр : Dihedron : Dihedron
Осоэдр : Hosohedron : Hosohedron
Многогранник Джонсона : Johnson solid : Johnson solid
Перестановочный многогранник : Permutohedron : Permutohedron
Многогранник Ханнера : Hanner polytope : Hanner polytope
Многогранник Силаши : Szilassi polyhedron : Szilassi polyhedron
Многогранник Часара : Császár polyhedron : Császár polyhedron
Многогранник Шёнхардта : Schönhardt polyhedron : Schönhardt polyhedron
Изгибаемый многогранник : Flexible polyhedron : Flexible polyhedron
Телесный угол : Solid angle : Solid angle
Соты : Honeycomb : Honeycomb (geometry)
Тело Кеплера — Пуансо : Kepler–Poinsot polyhedron : Kepler–Poinsot polyhedron
Аффинное многообразие : Affine manifold : Affine manifold
Атлас : Atlas : Atlas (topology)
Банахово расслоение : Banach bundle : Banach bundle
Векторное расслоение : Vector bundle : Vector bundle
Смятие : Crumpling : Crumpling
Различие (дефайти (я хз как это переводится)) : Diffiety : Diffiety
Эквифокальная гиперповерхность : Dupin hypersurface : Dupin hypersurface
Многообразие Илса — Кёйпера : Eells–Kuiper manifold : Eells–Kuiper manifold
Плотность многообразия : Density on a manifold : Density on a manifold
Конформно плоское многообразие : Conformally flat manifold : Conformally flat manifold
Коллапс : Collapsing manifold : Collapsing manifold
Многообразие Хакена : Haken manifold : Haken manifold
Гипербольческое многообразие : Hyperbolic manifold : Hyperbolic manifold
Линзовое пространство : Lens space : Lens space
Соответствие групп Ли - алгебр Ли : Lie group–Lie algebra correspondence : Lie group–Lie algebra correspondence
Нехаусдорфово многообразие : Non-Hausdorff manifold : Non-Hausdorff manifold
Многообразие Уайтхеда : Whitehead manifold : Whitehead manifold
Формула трубки : Weyl's tube formula : Weyl's tube formula
Теорема об униформизации : Uniformization theorem : Uniformization theorem
Трубчатая окрестность : Tubular neighborhood : Tubular neighborhood
Подмногообразие : Submanifold : Submanifold
Проблема Стинрода : Steenrod problem : Steenrod problem
Псевдомногообразие : Pseudomanifold : Pseudomanifold
Двойственность Пуанкаре : Poincaré duality : Poincaré duality
Перестройка Морса : Surgery theory : Surgery theory
Параллелизуемое многообразие : Parallelizable manifold : Parallelizable manifold
Изолированная точка кривой : Acnode : Acnode
Секторная скорость : Areal velocity : Areal velocity
Кривая Безье : Bézier curve : Bézier curve
Уравнение Чезаро : Cesàro equation : Cesàro equation
Дуга окружности : Circular arc : Circular arc
Циссоида : Cissoid : Cissoid
Крунод : Crunode : Crunode
Кривая постоянной ширины : Curve of constant width : Curve of constant width
Ориентация кривой : Curve orientation : Curve orientation
Исследование функции : Curve sketching : Curve sketching
Двойственная кривая : Dual curve : Dual curve
Эквихордный центр : Equichordal point : Equichordal point
Эволюта : Evolute : Evolute
Трёхгранник Френе : Frenet–Serret formulas : Frenet–Serret formulas
Эйлеров граф : Eulerian graph : Eulerian path
Параллельная кривая : Parallel curve : Parallel curve
Соприкасающаяся кривая : Osculating curve : Osculating curve
Соприкасающаяся окружность : Osculating circle : Osculating circle
Ортогональные траектории : Orthogonal trajectory : Orthogonal trajectory
Антиподера : Negative pedal curve : Negative pedal curve
Снежинка Мосли : Mosely snowflake : Mosely snowflake
Роза Мауэра : Maurer rose : Maurer rose
Коэффициент зацепления : Linking number : Linking number
Изофота : Isophote : Isophote
Инверсия кривой : Inverse curve : Inverse curve
Кривая пересечения : Intersection curve : Intersection curve
Гипотеза Тёплица : Inscribed square problem : Inscribed square problem
Неявная кривая : Implicit curve : Implicit curve
Гиперцикл : Hypercycle : Hypercycle (geometry)
Орисфера : Horosphere : Horosphere
Гороптер : Horopter : Horopter
Орицикл : Horocycle : Horocycle
Кривая Хюльстрема : Hjulström curve : Hjulström curve
Винтовая линия : Helix : Helix
Глиссетка : Glissette : Glissette
Подера : Pedal curve : Pedal curve
Псевдоголоморфная кривая : Pseudoholomorphic curve : Pseudoholomorphic curve
Кривая погони : Pursuit curve : Pursuit curve
Квадратриса : Quadratrix : Quadratrix
Радиус кривой : Radius of curvature : Radius of curvature
Секущая : Secant line : Secant line
Особая точка кривой : Singular point of a curve : Singular point of a curve
Кардиоида : Cardioid : Cardioid
Строфоида : Strophoid : Strophoid
Точка самоприкосновения : Tacnode : Tacnode
Кручение : Torsion of a curve : Torsion of a curve
Извилистость : Tortuosity : Tortuosity
1729 : Ramanujan's number : Ramanujan's number
Асанкхейя : Asaṃkhyeya : Asaṃkhyeya
Константа Бруна : Brun's theorem : Brun's theorem
Константа де Брёйна — Ньюмана : de Bruijn–Newman constant : de Bruijn–Newman constant
Константа Коморника — Лорети : Komornik–Loreti constant : Komornik–Loreti constant
Константа Майсселя — Мертенса : Meissel–Mertens constant : Meissel–Mertens constant
Постоянная омега : Omega constant : Omega constant
Постоянная Гаусса : Lemniscate constant : Lemniscate constant
Постоянная Гельфонда — Шнайдера : Gelfond–Schneider constant : Gelfond–Schneider constant
Постоянная Каталана : Catalan's constant : Catalan's constant
Простое число Бельфегора : Belphegor's prime : Belphegor's prime
Число Дотти : Dottie number : Dottie number
Число зверя : Number of the beast : Number of the beast
Число Скьюза : Skewes's number : Skewes's number
Куб : Cube : Cube
Римский додекаэдр : Roman dodecahedron : Roman dodecahedron
Полугиперкуб : Demihypercube : Demihypercube
Разбиение на ортосхемы : Dissection into orthoschemes : Dissection into orthoschemes
Плоскость : Euclidean plane : Euclidean plane
N-мерная грань : Face : Face (geometry)
Гиперплоскость : Hyperplane : Hyperplane
Гиперболоидная модель : Hyperboloid model : Hyperboloid model
Гиперпрямоугольник : Hyperrectangle : Hyperrectangle
Эллипсоид Джона : John ellipsoid : John ellipsoid
Пятиугольный многогранник : Pentagonal polytope : Pentagonal polytope
Семейства многогранников : Polytope families : Polytope families
Правильные многомерные многогранники : Regular polytope : Regular polytope
Трёхмерное пространство : Three-dimensional space : Three-dimensional space
Шар : Volume of an n-ball : Volume of an n-ball
Псевдотрёхмерность : 2.5D : 2.5D
Коразмерность : Codimension : Codimension
Комплексная размерность : Complex dimension : Complex dimension
Флатландия : Flatland : Flatland
Размерность Крулля : Krull dimension : Krull dimension
Ёмкость Минковского : Minkowski content : Minkowski content
Одномерное пространство : One-dimensional space : One-dimensional space
Базис Шаудера : Schauder basis : Schauder basis
Размерность Вапника — Червоненкиса : Vapnik–Chervonenkis dimension : Vapnik–Chervonenkis dimension
Кольцо (геометрия) : Annulus : Annulus (mathematics)
Поверхность Каталана : Catalan surface : Catalan surface
Коноид : Conoid : Conoid
Выпуклый конус : Convex cone : Convex cone
Эллипсоид : Ellipsoid : Ellipsoid
Геликоид : Helicoid : Helicoid
Гиперболоид : Hyperboloid : Hyperboloid
Срединная ось : Medial axis : Medial axis
Олоид : Oloid : Oloid
Параболоид : Paraboloid : Paraboloid
Коноид Плюккера : Plücker's conoid : Plücker's conoid
Линейчатая поверхность : Ruled surface : Ruled surface
Сферическая оболочка : Spherical shell : Spherical shell
Сферикон : Sphericon : Sphericon
Спидроны : Spidron : Spidron
Сквиркл : Squircle : Squircle
Стрелочные обозначения Конвея : Conway chained arrow notation : Conway chained arrow notation
Быстрорастущая иерархия : Fast-growing hierarchy : Fast-growing hierarchy
Теорема Гудстейна : Goodstein's theorem : Goodstein's theorem
Стрелочные обозначения Кнута : Knuth's up-arrow notation : Knuth's up-arrow notation
Обозначения Штейнгауза — Мозера : Steinhaus–Moser notation : Steinhaus–Moser notation
SSCG : SSCG : Friedman's SSCG function
BH(n) : BH(n) : Buchholz hydra
Экспоненциальная запись : Scientific notation : Scientific notation
Расширенная числовая прямая : Extended real number line : Extended real number line
Наибольшее известное простое число : Largest known prime number : Largest known prime number
Системы наименования чисел : Long and short scales : Long and short scales
Число Мерсенна : Mersenne prime : Mersenne prime
Суперлогарифм : Super-logarithm : Super-logarithm
Суперкорень : Super-root : Tetration
Бесконечность : Infinity : Infinity
Иерархия алефов : Aleph number : Aleph number
Аксиома бесконечности : Axiom of infinity : Axiom of infinity
Бет-число : Beth number : Beth number
Диагональный аргумент : Cantor's diagonal argument : Cantor's diagonal argument
Деление на ноль : Division by zero : Division by zero
Идеальная точка : Ideal point : Ideal point
Принцип непрерывности : Law of continuity : Law of continuity
Поле Леви-Чевиты : Levi-Civita field : Levi-Civita field
Нестандартное исчисление : Nonstandard calculus : Nonstandard calculus
Бесконечно удалённая точка : Point at infinity : Point at infinity
Проективно расширенная числовая прямая : Projectively extended real line : Projectively extended real line
Полубесконечность : Semi-infinite : Semi-infinite
Супердействительное число : Superreal number : Superreal number
Ультрафинитизм : Ultrafinitism : Ultrafinitism
Финитизм : Finitism : Finitism
Несчётное множество : Uncountable set : Uncountable set
Ряд Гранди : Grandi's series : Grandi's series
0,(9) : 0.999... : 0.999...
Знакочередующийся ряд натуральных чисел : 1 − 2 + 3 − 4 + ⋯ : 1 − 2 + 3 − 4 + ⋯
Парадокс Берри : Berry paradox : Berry paradox
Парадокс Бертрана : Bertrand paradox : Bertrand paradox (probability)
Парадокс Браеса : Braess's paradox : Braess's paradox
Равновесие Нэша : Nash equilibrium : Nash equilibrium
Теорема Хаусдорфа : Hausdorff paradox : Hausdorff paradox
Парадокс Клини — Россера : Kleene–Rosser paradox : Kleene–Rosser paradox
Исчезновение клетки : Missing square puzzle : Missing square puzzle
Парадокс Паррондо : Parrondo's paradox : Parrondo's paradox
Парадокс Ришара : Richard's paradox : Richard's paradox
Сапог Шварца : Schwarz lantern : Schwarz lantern
Парадокс Скулема : Skolem's paradox : Skolem's paradox
Функция Аккермана : Ackermann function : Ackermann function
Большие числа Дирака : Dirac large numbers hypothesis : Dirac large numbers hypothesis
Иерархия Харди : Hardy hierarchy : Hardy hierarchy
Медленнорастущая иерархия : Slow-growing hierarchy : Slow-growing hierarchy
Пси-функции Бухгольца : Buchholz psi functions : Buchholz psi functions
Функция Веблена : Veblen function : Veblen function
Числа эпсилон : Epsilon number : Epsilon number
Неподвижная точка : Fixed point : Fixed point (mathematics)
Точная верхняя и нижняя границы : Infimum and supremum : Infimum and supremum
Предельный ординал : Limit ordinal : Limit ordinal
Вариационный метод : Variational method : Variational method (quantum mechanics)
Алгебра Вирасоро : Virasoro algebra : Virasoro algebra
Горизонт Киллинга : Killing horizon : Killing horizon
Поле Киллинга : Killing vector field : Killing vector field
Главное расслоение : Principal bundle : Principal bundle
Квантовая геометрия : Quantum geometry : Quantum geometry
Классификация Вигнера : Wigner's classification : Wigner's classification
Метод фиктивных областей : Fictitious domain method : Fictitious domain method
Многообразие Эйнштейна : Einstein manifold : Einstein manifold
Метрический тензор : Metric tensor : Metric tensor
Обобщённая функция : Generalized function : Generalized function
Оператор Дирака : Dirac operator : Dirac operator
Преобразование Вейерштрасса : Weierstrass transform : Weierstrass transform
Gaussian function : Гауссова функция : Гауссова функция
Произведение Мояля : Moyal product : Moyal product
Суперматематика : Supermathematics : Supermathematics
Твистор : Twistor theory : Twistor theory
Уравнение Винера — Хопфа : Wiener–Hopf method : Wiener–Hopf method
Функциональная производная : Functional derivative : Functional derivative
Производная по направлению : Directional derivative : Directional derivative
Парадокс Бурали-Форти : Burali-Forti paradox : Burali-Forti paradox
Кофинальность : Cofinality : Cofinality
Первый неисчислимый ординал : First uncountable ordinal : First uncountable ordinal
Пентация : Pentation : Pentation
Трансфинитная индукция : Transfinite induction : Transfinite induction
Математическая индукция : Mathematical induction : Mathematical induction
Вполне упорядоченное множество : Well-order : Well-order
Отношение : Finitary relation : Finitary relation
Антицепь : Antichain : Antichain
Градуированное частично упорядоченное множество : Graded poset : Graded poset
Лемма Цорна : Zorn's lemma : Zorn's lemma
Линейно упорядоченное множество : Total order : Total order
Максимальные и минимальные элементы : Maximal and minimal elements : Maximal and minimal elements
Направленное множество : Directed set : Directed set
Пустое множество : Empty set : Empty set
Непрерывность по Скотту : Scott continuity : Scott continuity
Ограниченность : Bounded set : Bounded set
Плотный порядок : Dense order : Dense order
Порядок Брюа : Bruhat order : Bruhat order
Последовательно-параллельный частичный порядок : Series-parallel partial order : Series-parallel partial order
Причинные множества : Causal sets : Causal sets
Структура событий : Event structure : Event structure
Теорема Дилуорса : Dilworth's theorem : Dilworth's theorem
Теорема Клини о неподвижной точке : Kleene fixed-point theorem : Kleene fixed-point theorem
Теорема Шнайдера : Schnyder's theorem : Schnyder's theorem
Теорема Шпильрайна : Szpilrajn extension theorem : Szpilrajn extension theorem
Транзитивное множество : Transitive set : Transitive set
Ультрафильтр : Ultrafilter : Ultrafilter
Частично упорядоченное множество : Partially ordered set : Partially ordered set
Эйлерово частично упорядоченное множество : Eulerian poset : Eulerian poset
Антидеситтеровское пространство : Anti-de Sitter space : Anti-de Sitter space
Асимптотическая формула Вейля : Weyl law : Weyl law
Вторая квадратичная форма : Second fundamental form : Second fundamental form
Обобщённая формула Гаусса — Бонне : Chern–Gauss–Bonnet theorem : Chern–Gauss–Bonnet theorem
Геодезическая : Geodesic : Geodesic
Гипотеза Бляшке : Wiedersehen pair : Wiedersehen pair
Душа : Soul theorem : Soul theorem
Задача о предписанной скалярной кривизне : Prescribed scalar curvature problem : Prescribed scalar curvature problem
Задача Ямабе : Yamabe problem : Yamabe problem
Калибровочная дифференциальная форма : Calibrated geometry : Calibrated geometry
Классификация Петрова : Petrov classification : Petrov classification
Ковариантная производная : Covariant derivative : Covariant derivative
Конформное отображение : Conformal map : Conformal map
Кривизна : Curvature : Curvature
Кривизна римановых многообразий : Curvature of Riemannian manifolds : Curvature of Riemannian manifolds
Криволинейная система координат : Curvilinear coordinates : Curvilinear coordinates
Лемма Гаусса о геодезических : Gauss's lemma : Gauss's lemma (Riemannian geometry)
Лемма Маргулиса : Margulis lemma : Margulis lemma
Лемма Синга : Synge's theorem : Synge's theorem
Метрика Лоренца : Spacetime metric : Spacetime metric
Метрика Сасаки : Sasaki metric : Sasaki metric
Метрическая связность : Metric connection : Metric connection
Множество раздела : Cut locus : Cut locus (Riemannian manifold)
Дизъюнктивная нормальная форма : DNF : Disjunctive normal form
Конъюнктивная нормальная форма : CNF : Conjunctive normal form
Неравенство Бишопа — Громова : Bishop–Gromov inequality : Bishop–Gromov inequality
Неравенство Пу : Pu's inequality : Pu's inequality
Неравенство Римана — Пенроуза : Riemannian Penrose inequality : Riemannian Penrose inequality
Нормальное расслоение : Normal bundle : Normal bundle
Нормальные координаты : Normal coordinates : Normal coordinates
Касательное пространство : Tangent space : Tangent space
Оператор Лапласа — Бельтрами : Laplace–Beltrami operator : Laplace–Beltrami operator
Ортогональная система координат : Orthogonal coordinates : Orthogonal coordinates
Основная теорема римановой геометрии : Fundamental theorem of Riemannian geometry : Fundamental theorem of Riemannian geometry
Параллельное перенесение : Parallel transport : Parallel transport
Инъекция : Injection : Injective function
Сюръекция : Surjection : Surjective function
Первая квадратичная форма : First fundamental form : First fundamental form
Поверхность Макбита : Macbeath surface : Macbeath surface
Поверхность Цолля : Zoll surface : Zoll surface
Поле Якоби : Jacobi field : Jacobi field
Поток Риччи : Ricci flow : Ricci flow
Поток средней кривизны : Mean curvature flow : Mean curvature flow
Почти плоское многообразие : Almost flat manifold : Almost flat manifold
Пространственная форма : Space form : Space form
Псевдориманово многообразие : Pseudo-Riemannian manifold : Pseudo-Riemannian manifold
Разложение Риччи : Ricci decomposition : Ricci decomposition
Риманова субмерсия : Riemannian submersion : Riemannian submersion
Риманово многообразие : Riemannian manifold : Riemannian manifold
Риччи-солитон : Ricci soliton : Ricci soliton
Связность Леви-Чивиты : Levi-Civita connection : Levi-Civita connection
Секционная кривизна : Sectional curvature : Sectional curvature
Символы Кристоффеля : Christoffel symbols : Christoffel symbols
Симметрическое пространство : Symmetric space : Symmetric space
Симметрия : Symmetry : Symmetry in mathematics
Систолическое неравенство : Gromov's systolic inequality for essential manifolds : Gromov's systolic inequality for essential manifolds
Сопряжённые точки : Conjugate points : Conjugate points
Сопряжённые числа : Complex conjugate : Complex conjugate
Спинорное расслоение : Spinor bundle : Spinor bundle
Спинор : Spinor : Spinor
Существенное многообразие : Essential manifold : Essential manifold
Сферы Берже : Berger's sphere : Berger's sphere
Тензор Вейля : Weyl tensor : Weyl tensor
Теорема Адамара — Картана : Cartan–Hadamard theorem : Cartan–Hadamard theorem
Теорема геометризации : Geometrization conjecture : Geometrization conjecture
Теорема Громова о компактности : Gromov's compactness theorem : Gromov's compactness theorem (geometry)
Теорема Майерса — Стинрода : Myers–Steenrod theorem : Myers–Steenrod theorem
Теорема Нэша о регулярных вложениях : Nash embedding theorems : Nash embedding theorems
Теорема о расщеплении : Splitting theorem : Splitting theorem
Теорема о сфере : Sphere theorem : Sphere theorem
Теорема сравнения Рауха : Rauch comparison theorem : Rauch comparison theorem
Теорема сравнения Топоногова : Toponogov's theorem : Toponogov's theorem
Теорема Хопфа — Ринова : Hopf–Rinow theorem : Hopf–Rinow theorem
Теорема Шура о постоянной кривизне : Schur's lemma : Schur's lemma (Riemannian geometry)
Тождество Бохнера : Bochner's formula : Bochner's formula
Третья квадратичная форма : Third fundamental form : Third fundamental form
Филинг-радиус : Filling radius : Filling radius
Формула Гаусса — Бонне : Gauss–Bonnet theorem : Gauss–Bonnet theorem
Экспоненциальное отображение : Exponential map : Exponential map (Riemannian geometry)
G2-многообразие : G2 manifold : G2 manifold
Theorema Egregium : Theorema Egregium : Theorema Egregium
Абстрактный клеточный комплекс : Abstract cell complex : Abstract cell complex
Букет пространств : Wedge sum : Wedge sum
Вычислительная топология : Computational topology : Computational topology
Гекс : Hex : Hex (board game)
Гипотеза Арнольда — Гивенталя : Arnold–Givental conjecture : Arnold–Givental conjecture
Граф Риба : Reeb graph : Reeb graph
Движения Пахнера : Pachner moves : Pachner moves
Дом Бинга : House with two rooms : House with two rooms
Когомологии Александрова — Чеха : Čech cohomology : Čech cohomology
Комплексное многообразие : Complex manifold : Complex manifold
Конфигурационное пространство : Configuration space : Configuration space (mathematics)
Локально выпуклое пространство : Locally convex topological vector space : Locally convex topological vector space
Надстройка : Suspension : Suspension (topology)
Накрытие : Covering space : Covering space
Нерв покрытия : Nerve complex : Nerve complex
Объемлющая изотопия : Ambient isotopy : Ambient isotopy
Озёра Вады : Lakes of Wada : Lakes of Wada
Ориентация : Orientability : Orientability
Открытая книга : Open book decomposition : Open book decomposition
Относительная внутренность : Relative interior : Relative interior
Петля в топологическом пространстве : Loop in topological space : Loop (topology)
Плёнка Мёбиуса : Cross-cap : Möbius strip
Поверхность : Surface : Surface (mathematics)
Погружение : Immersion : Immersion (mathematics)
Принцип разделимости : Separated sets : Separated sets
Путь (топология) : Path in topological space : Path (topology)
Разбиение единицы : Partition of unity : Partition of unity
Расстояние Фреше : Fréchet distance : Fréchet distance
Рогатая сфера Александера : Alexander horned sphere : Alexander horned sphere
Росток : Germ : Germ (mathematics)
Пространство Колмогорова : Kolmogorov space : Kolmogorov space
Т1 пространство : T1 space : T1 space
Пространства Урысона и вполне Хаусдорфово : Urysohn and completely Hausdorff spaces : Urysohn and completely Hausdorff spaces
Регулярное пространство : Regular space : Regular space
Вполне регулярное пространство : Tychonoff space : Tychonoff space
Нормальное пространство : Normal space : Normal space
Сим : Sim : Sim (pencil game)
Симплициальная сфера : Simplicial sphere : Simplicial sphere
Симплициальный объём : Simplicial volume : Simplicial volume
Слабая гомотопическая эквивалентность : Weak equivalence : Weak equivalence (homotopy theory)
Слоение : Foliation : Foliation
Теорема Атьи — Зингера об индексе : Atiyah–Singer index theorem : Atiyah–Singer index theorem
Теорема Брауэра о неподвижной точке : Brouwer fixed-point theorem : Brouwer fixed-point theorem
Теорема Жордана : Jordan curve theorem : Jordan curve theorem
Теорема Новикова о компактном слое : Novikov's compact leaf theorem : Novikov's compact leaf theorem
Теорема о двойной надстройке : Double suspension theorem : Double suspension theorem
Теорема Риба о сфере : Reeb sphere theorem : Reeb sphere theorem
Теорема Риба об устойчивости : Reeb stability theorem : Reeb stability theorem
Теорема Сарда : Sard's theorem : Sard's theorem
Топологическое пространство : Topological space : Topological space
Триангуляция : Triangulation : Triangulation (geometry)
Задача о триангуляции многоугольника : Polygon triangulation : Polygon triangulation
Симплициальный комплекс : Simplicial complex : Simplicial complex
Триангуляция Делоне : Delaunay triangulation : Delaunay triangulation
Шутовской колпак : Dunce hat : Dunce hat (topology)
F-сигма-множество : Fσ set : Fσ set
Векторные расслоения на алгебраических кривых : Vector bundles on algebraic curves : Vector bundles on algebraic curves
Алгебраическая кривая : Algebraic curve : Algebraic curve
Индуцированное расслоение : Pullback bundle : Pullback bundle
Касательное расслоение : Tangent bundle : Tangent bundle
Локально тривиальное расслоение : Fiber bundle : Fiber bundle
Накрывающая гомотопия : Homotopy lifting property : Homotopy lifting property
Расслоение : Bundle : Bundle (mathematics)
Степень отображения : Degree of a continuous mapping : Degree of a continuous mapping
Связная сумма : Connected sum : Connected sum
Бордизм : Cobordism : Cobordism
Расслоение Зейферта : Seifert fiber space : Seifert fiber space
Расслоение на окружности : Circle bundle : Circle bundle
Расслоение Хопфа : Hopf fibration : Hopf fibration
Тензорное расслоение : Tensor bundle : Tensor bundle
Аффинная система координат : Affine coordinates : Affine space
Барицентрические координаты : Barycentric coordinate system : Barycentric coordinate system
Биангулярная система координат : Biangular coordinates : Biangular coordinates
Биполярная система координат : Bipolar coordinates : Bipolar coordinates
Бицентрическая система координат : Two-center bipolar coordinates : Two-center bipolar coordinates
Геоцентрические координаты : Geocentric coordinate system : Earth-centered, Earth-fixed coordinate system
Гиперболическая система координат : Hyperbolic coordinates : Hyperbolic coordinates
Горизонтальная система координат : Horizontal coordinate system : Horizontal coordinate system
Дифференциальные операторы в различных системах координат : Del in cylindrical and spherical coordinates : Del in cylindrical and spherical coordinates
Канонические координаты : Canonical coordinates : Canonical coordinates
Конические координаты : Conical coordinates : Conical coordinates
Однородная система координат : Homogeneous coordinates : Homogeneous coordinates
Параболическая система координат : Parabolic coordinates : Parabolic coordinates
Прямоугольная система координат : Cartesian coordinate system : Cartesian coordinate system
Координаты Риндлера : Rindler coordinates : Rindler coordinates
Сферическая система координат : Spherical coordinate system : Spherical coordinate system
Тороидальная система координат : Toroidal coordinates : Toroidal coordinates
Трилинейная система координат : Trilinear coordinates : Trilinear coordinates
Цилиндрическая система координат : Cylindrical coordinate system : Cylindrical coordinate system
Цилиндрические параболические координаты : Parabolic cylindrical coordinates : Parabolic cylindrical coordinates
Эллипсоидальные координаты : Ellipsoidal coordinates : Ellipsoidal coordinates
Эллиптическая система координат : Elliptic coordinate system : Elliptic coordinate system
Группа треугольника (2,3,7) : (2,3,7) triangle group : (2,3,7) triangle group
Поверхность Больцы : Bolza surface : Bolza surface
Поверхность Гурвица : Hurwitz surface : Hurwitz surface
Систола поверхности : Systoles of surfaces : Systoles of surfaces
Абелев интеграл : Abelian integral : Abelian integral
Астроида : Astroid : Astroid
Бикасательная : Bitangent : Bitangent
Бикасательные плоской кривой четвёртой степени : Bitangents of a quartic : Bitangents of a quartic
Гипотеза Нагаты о кривых : Nagata's conjecture on curves : Nagata's conjecture on curves
Глобальное поле : Global field : Global field
Двурогая кривая : Bicorn : Bicorn
Декартов лист : Folium of Descartes : Folium of Descartes
Дельтоида : Deltoid curve : Deltoid curve
Каппа : Kappa curve : Kappa curve
Квадрифолий : Quadrifolium : Quadrifolium
Квартика Люрота : Lüroth quartic : Lüroth quartic
Конхоида Слюза : Conchoid of de Sluze : Conchoid of de Sluze
Кривая Бринга : Bring's curve : Bring's curve
Кривая моментов : Moment curve : Moment curve
Кривая Персея : Spiric section : Spiric section
Кубика Чирнгауза : Tschirnhausen cubic : Tschirnhausen cubic
Лемниската : Lemniscate : Lemniscate
Лемниската Бернулли : Lemniscate of Bernoulli : Lemniscate of Bernoulli
Лемниската Бута : Hippopede : Hippopede
Лемниската Жероно : Lemniscate of Gerono : Lemniscate of Gerono
Модулярная кривая : Modular curve : Modular curve
Нефроида : Nephroid : Nephroid
Овал Декарта : Cartesian oval : Cartesian oval
Овал : Oval : Oval
Улитка Паскаля : Limaçon : Limaçon
Овал Кассини : Cassini oval : Cassini oval
Полукубическая парабола : Semicubical parabola : Semicubical parabola
Пулевидная кривая : Bullet-nose curve : Bullet-nose curve
Геометрический род : Geometric genus : Geometric genus
Рациональная нормальная кривая : Rational normal curve : Rational normal curve
Синусоидальная спираль : Sinusoidal spiral : Sinusoidal spiral
Теорема Белого : Belyi's theorem : Belyi's theorem
Теорема Хассе : Hasse's theorem on elliptic curves : Hasse's theorem on elliptic curves
Трезубец : Trident curve : Trident curve
Формула Плюккера : Plücker formula : Plücker formula
Циссоида Диокла : Cissoid of Diocles : Cissoid of Diocles
N-эллипс : n-ellipse : n-ellipse
Математическая физика : Mathematical physics : Mathematical physics
Математическая химия : Mathematical chemistry : Mathematical chemistry
Гусеница : Caterpillar tree : Caterpillar tree
Индекс Хосойи : Hosoya index : Hosoya index
Молекулярный граф : Molecular graph : Molecular graph
Индекс Рандича : Randić's molecular connectivity index : Randić's molecular connectivity index
Топологический индекс : Topological index : Topological index
Химическая теория графов : Chemical graph theory : Chemical graph theory
Частичный куб : Partial cube : Partial cube
Граф гиперкуба : Hypercube graph : Hypercube graph
Спектральная теория графов : Spectral graph theory : Spectral graph theory
Автоморфизм графа : Graph automorphism : Graph automorphism
Гомоморфизм графов : Graph homomorphism : Graph homomorphism
Характерная раскраска : Distinguishing coloring : Distinguishing coloring
Степень вершины : Degree : Degree (graph theory)
Лемма о рукопожатиях : Handshaking lemma : Handshaking lemma
Алгоритм Гавела — Хакими : Havel–Hakimi algorithm : Havel–Hakimi algorithm
Рекурсия : Recursion : Recursion
Замыкание : Closure : Closure (mathematics)
Автомодельное решение : Self-similar solution : Self-similar solution
Алгоритм Булирша-Штёра : Bulirsch–Stoer algorithm : Bulirsch–Stoer algorithm
Алгоритм вычисления собственных значений : Eigenvalue algorithm : Eigenvalue algorithm
Алгоритм де Кастельжо : De Casteljau's algorithm : De Casteljau's algorithm
Многочлен Бернштейна : Bernstein polynomial : Bernstein polynomial
Алгоритм Ремеза : Remez algorithm : Remez algorithm
Схема Горнера : Horner's method : Horner's method
Вычислительная устойчивость : Numerical stability : Numerical stability
Число обусловленности : Condition number : Condition number
Градиентные методы : Gradient method : Gradient method
Корректно поставленная задача : Well-posed problem : Well-posed problem
Уравнение Лапласа : Laplace's equation : Laplace's equation
Теорема Лапласа : Laplace expansion : Laplace expansion
Критерий Сильвестра : Sylvester's criterion : Sylvester's criterion
Уравнение диффузии : Diffusion equation : Diffusion equation
Метод регуляризации Тихонова : Tikhonov regularization : Ridge regression
Коэффициенты формул численного дифференцирования : Finite difference coefficient : Finite difference coefficient
Матрица жёсткости : Stiffness matrix : Stiffness matrix
Кубический сплайн : Spline interpolation : Spline interpolation
Метод Галёркина : Galerkin method : Galerkin method
Факторизация многочленов : Factorization of polynomials : Factorization of polynomials
Метод простой итерации : Fixed-point iteration : Fixed-point iteration
Метод Рунге — Кутты : Runge–Kutta methods : Runge–Kutta methods
Метод сопряжённых градиентов : Nonlinear conjugate gradient method : Nonlinear conjugate gradient method
Метод Хартри — Фока : Hartree–Fock method : Hartree–Fock method
Метод Якоби для собственных значений : Jacobi eigenvalue algorithm : Jacobi eigenvalue algorithm
Аппроксимация : Approximation : Approximation
Подпространство Крылова : Krylov subspace : Krylov subspace
Линейная комбинация : Linear combination : Linear combination
Линейная независимость : Linear independence : Linear independence
Ранг матрицы : Rank : Rank (linear algebra)
Минор : Minor : Minor (linear algebra)
Приближение с помощью кривых : Curve fitting : Curve fitting
Разделённая разность : Divided differences : Divided differences
Численное решение уравнений : Root-finding algorithms : Root-finding algorithms
Скорость сходимости : Rate of convergence : Rate of convergence
Теория приближений : Approximation theory : Approximation theory
Численное дифференцирование : Numerical differentiation : Numerical differentiation
Аппроксимация Паде : Padé approximant : Padé approximant
АТС-теорема : ATS theorem : ATS theorem
Многочлены Фабера : Faber polynomials : Faber polynomials
Модуль непрерывности : Modulus of continuity : Modulus of continuity
Наипростейшая дробь : Partial fractions in complex analysis : Partial fractions in complex analysis
Неравенство Джексона — Стечкина : Jackson's inequality : Jackson's inequality
Обратная параболическая интерполяция : Inverse quadratic interpolation : Inverse quadratic interpolation
Теорема Вейерштрасса — Стоуна : Stone–Weierstrass theorem : Stone–Weierstrass theorem
Теорема Вейерштрасса о функции на компакте : Extreme value theorem : Extreme value theorem
Теорема Колмогорова — Арнольда : Kolmogorov–Arnold representation theorem : Kolmogorov–Arnold representation theorem
Тригонометрический многочлен : Trigonometric polynomial : Trigonometric polynomial
Формула Стирлинга : Stirling's approximation : Stirling's approximation
Формула Эйлера — Маклорена : Euler–Maclaurin formula : Euler–Maclaurin formula
Ядро Дирихле : Dirichlet kernel : Dirichlet kernel
Ядро Фейера : Fejér kernel : Fejér kernel
B-сплайн : B-spline : B-spline
Интерполяция : Interpolation : Interpolation
Экстраполяция : Extrapolation : Extrapolation
Задача Тарского по школьной алгебре : Tarski's high school algebra problem : Tarski's high school algebra problem
Линейная функция : Linear function : Linear function (calculus)
Линейное уравнение : Linear equation : Linear equation
Система уравнений : System of equations : System of equations
СЛАУ : System of linear equations : System of linear equations
Ортогональное преобразование : Orthogonal transformation : Orthogonal transformation
Ортогональная матрица : Orthogonal matrix : Orthogonal matrix
Композиция функций : Function composition : Function composition
Тождество Брахмагупты — Фибоначчи : Brahmagupta–Fibonacci identity : Brahmagupta–Fibonacci identity
Делимость : Divisor of an integer : Divisor
Дистрибутивность : Distributive property : Distributive property
Коммутативность : Commutative property : Commutative property
Неравенство Бернулли : Bernoulli's inequality : Bernoulli's inequality
Неравенство Чебышёва для сумм : Chebyshev's sum inequality : Chebyshev's sum inequality
Несократимая дробь : Irreducible fraction : Irreducible fraction
Обратное число : Multiplicative inverse : Multiplicative inverse
Округление : Rounding : Rounding
Относительное изменение : Relative change and difference : Relative change and difference
Перенос : Carry : Carry (arithmetic)
Пропорциональность : Proportionality : Proportionality (mathematics)
Противоположное число : Additive inverse : Additive inverse
Равенство : Equality : Equality (mathematics)
Сумма цифр : Digit sum : Digit sum
Счётные палочки : Counting rods : Counting rods
Тождество максимумов и минимумов : Maximum-minimums identity : Maximum-minimums identity
Транснеравенство : Rearrangement inequality : Rearrangement inequality
Монотонная функция : Monotonic function : Monotonic function
Функция Кармайкла : Carmichael function : Carmichael function
Деление с остатком : Euclidean division : Euclidean division
Функция Гомпертца : Gompertz function : Gompertz function
Константная функция : Constant function : Constant function
Одночлен : Monomial : Monomial
Показательная функция : Exponential function : Exponential function
Рациональная функция : Rational function : Rational function
Функция Гудермана : Gudermannian function : Gudermannian function